EA ./assets/textures/walls/stone_bricks/1.xpm

SO ./assets/textures/walls/stone_bricks/2.xpm

NO ./assets/textures/walls/stone_bricks/3.xpm

WE ./assets/textures/walls/stone_bricks/4.xpm

S ./assets/sprites/barrel.xpm

R 1280 800
F ./assets/textures/floor/sand.xpm
C ./assets/sky/mountains/mountains.xpm

11111111111111111111111111111
10000000000000000000000000001
10000000000000000000000000001
10000000000000000000000000001
10000000000000000000000000001
10000000000000000000000000001
100000000000E0000000000000001
10000000000000000000000000001
10000000000000000000000000001
10000000000000000000000000001
10000000000000000000000000001
10000000000000000000000000001
10000000000000000000000000001
11111111111111111111111111111