EA ./assets/textures/walls/stone_bricks/1.xpm

SO ./assets/textures/walls/stone_bricks/2.xpm

NO ./assets/textures/walls/stone_bricks/3.xpm

WE ./assets/textures/walls/stone_bricks/4.xpm

S ./assets/sprites/barrel.xpm

R 1280 800
F ./assets/textures/floor/sand.xpm
C ./assets/sky/mountains/mountains.xpm

      111
     10S01
    1000001
    1000001
    1000001
    1000001
     10001
     10001
     10001
     10001                                1111111
 111110001111111111111111111           1110000000111
10000000000000000000000000001        11000000000000011
10000000000000000000000000111       1000000000000000001
10000000000000000000000000000111111100000000000000000001
 11100000000000011111100000000000000000000000000000000001
    1000000000001   1000000000000000000000000000000000001
    1000000000001   100000000111111100000000000000000001
    10000000000001111000000111      1000000000000000001
 111000000000000000000000001         11000000000000011
1000000000000000100000111111           1110000000111
1000000111110000000001                    1100001
1000001     100000001       111111111111111100001
1000001     100000001       100000000000000000001
 11111       1111111        100000000000000000001
                            111111111111111111111
